111111
1P0E01
100001
1C0C01
111111