111111111
100Pw0001
100r00E01
1000C0001
111111111