111111111
100000001
100000E01
1000P0001
111111111